 ##### ########### ### ########### ##### 
#.....#...........#...#...........#.....#
#.#.###.###.#####.#.#.#.#####.###.#.###.#
#.#.#...#.#.....#...#.#.#...#...#.#.#...#
#.#.#.###.#####.#####.#.#.#####.###.#.#.#
#.#.#.#...#.....#...#.#.#.....#.....#.#.#
#.#.#.#.#.#.#####.#.#.#.###.#.#######.#.#
#.#.#.#.#.#...#...#...#...#.#.....#.#.#.#
#.#.#.###.###.###########.###.###.#.#.#.#
#.#O#...#...#...#.......#.#...#...#.#.#.#
#.#####.###.###.#.###.###.#.###.###.#.## 
#.#.........#...#.#.#...#.#.#.#...#.#...#
#.#.#########.###.#.###.#.#.#.###.#.###.#
#...#...#.....#...#...#.....#.....#.#...#
#.###.###.###.#.###.#####.#####.###.#.## 
#.#...#...#...#.#...#...#.#...#.....#.#.#
#.###.#.###.###.###.#.#.###.#.#######.#.#
#.#...#.#...#.#.#...#.#.....#.#.......#.#
#.#.###.#.###.#.#.#.#.#######.#.#######.#
#...#...#.....#...#.#...#...#.#.....#...#
 ####.#.#########.#####.#.###.#####.###.#
#.....#.#.........#D....#...#.......#...#
#.#######.#################.#########.#.#
#.........#.....#.........#.....#.....#.#
#.#########.#.###.#####.#.#.###.#.#.###.#
#...#...#...#.....#.....#.#.#.#.#.#...#.#
 ##.#.#.#.#########.#####.#.#.#.#####.## 
#...#.#...#.........#...#...#.#.....#...#
#.###.#####.#########.#.#####.#####.###.#
#.#.......#...#.......#...........#.....#
#.###########.#.###### ######.#########.#
#.............#...#...#.......#.......#.#
 ############# ##.###.#.#######.###.###.#
#.......#.....#...#...#...#...#...#.....#
#.#####.#.#.###.###.#####.#.#.###.###### 
#.....#.#.#...#.....#.....#.#...#.#.....#
 ####.#.#.###.###.###.#####.###.#.###.#.#
#.#...#.#.#.#...#.#...#...#.#.#.#.....#.#
#.#.###.#.#.###.#.#.###.#.#.#.#.#######.#
#.....#.......#...#.....#.....#.........#
 ##### ####### ### ##### ##### ######### 