 ###   ########### ### ########### ##### 
#...  #...........#...#...........#.....#
#.#.###.###.#####.#.#.#.#####.###.#.###.#
#.#.#...#.#.....#...#.#.#...#...#.#.#... 
#.#.#.###.#####.#####.#.#.#####.###.#.#  
#.#.#.#...#.....#...#.#.#.....#.....#.#  
#.#.#.#.#.#.#####.#.#.#.###.#.#######.#  
#.#.#.#.#.#...#...#...#...#.#.....#.#.#  
#.#.#.###.###.###########.###.###.#.#.#  
#.#O#...#...#...#.......#.#...#...#.#.#  
#.#####.###.###.#.###.###.#.###.###.#.## 
#.#.........#...#.#.#...#.#.#.#...#.#...#
#.#.#########.###.#.###.#.#.#.###.#.###.#
 ...#...#.....#...#...#.....#.....#.#... 
#.###.###.### #.###.##### #####.###.#.## 
#.#...#...    #.#...#...  #...#.....#.#.#
#.###.#.#     #.###.#.#.###.#.#######.#.#
#.#...#.#     #.#...#.#.....#.#.......#.#
#.#.###.#     #.#.#.#.#######.#.#######.#
#...#...      #...#.#...#...#.#.....#...#
 ####.#  ########.#####.#.###.#####.###.#
#.....  #.........#SD...#...#.......#...#
#.#######.#################.#########.#.#
 .........#.....#.........#.....#.....#.#
#.#########.#.###.#####.#.#.###.#.#.###.#
#...#...#...#.....#.....#.#.#.#.#.#...#.#
 ##.#.#.#.#########.#####.#.#.#.#####.## 
#...#.#...#.........#...#...#.#.....#...#
#.###.#####.#########.#.#####.#####.###.#
#.#.......#...#.......#...........#.....#
#.###########.#.###### ######.#########.#
#.............#...#...#.......#.......#.#
 ############# ##.###.#.#######.###.###.#
#.......#.....#...#...#...#...#...#.....#
#.#####.#.#.###.###.#####.#.#.###.###### 
#.....#.#.#...#.....#.....#.#...#.#.....#
 ####.#.#.###.###.###.#####.###.#.###.#.#
#.#...#.#.#.#...#.#...#...#.#.#.#.....#.#
#.#.###.#.#.###.#.#.###.#.#.#.#.#######.#
#.....#.......#...#.....#.....#.........#
 ##### ####### ### ##### ##### ######### 
